EA textures/shreck_chad_1.xpm
 WE textures/zemmour.xpm
   C 255,25,100
       SO textures/patrick2.xpm
     NO textures/bob.xpm

F 10,100,10

1111111
1010001
1010001
1011001
1000001
1000W01
1000001
1111111
