EA textures/bob.xpm
 WE textures/patrick2.xpm
   C 170,210,230
       SO textures/shreck_chad_1.xpm
     NO textures/zemmour.xpm

F 100,100,110

1111111111111111
10000000000000001
10000000000000001
10000000000000001
10000000000000001
10000000000000001
10000000000000001
10000000000000001
10000000000000001
100000000S0000001
10000000000000001
10000000000000001
10000000000000001
10000000000000001
10000000000000001
1111111111111111
