11111111111111111
1000000C000000001
10000000000000001
10000000000000001
10000000000100001
10000000000000001
10000111110000001
10000000000000001
10000000000000001
1P0000000000000E1
11111111111111111