11111111111
1011C1001C1
10010000001
10011110011
10000E00101
10010001101
1001P001001
10111000001
1C101000101
11111111111