1111111
1C0P001
1101101
10E0101
1111111